mỹ	USA
anh	United Kingdom 
trung quốc	China
lào	Laos
thái	Thailand
thái lan	Thailand
hàn quốc	South Korea
hàn	South Korea
triều tiên	North Korea
nhật	Japan
nhật bản	Japan
việt	Vietnam
việt nam	Vietnam
pháp	France
đức	Germany
ấn độ	India
tây ban nha	Spain
singapore	Singapore
nga	Russia
liên xô	Russia
hồng kong	Hong Kong
hồng kông	Hong Kong
hong kong	Hong Kong
hongkong	Hong Kong
my	USA
trung quoc	China
lao	Laos
thai	Thailand
thai lan	Thailand
han quoc	South Korea
han	South Korea
trieu tien	North Korea
nhat	Japan
nhat ban	Japan
viet	Vietnam
viet nam	Vietnam
phap	France
duc	Germany
an do	India
tay ban nha	Spain
lien xo	Russia
hong kong	Hong Kong
hong kong	Hong Kong
